11111111111111111
1P10C0I111C00I0C1
10C0IC0C000I01001
10I100101111C0CI1
1C01IC10CI01I00E1
1I01111011110C0I1
1C000I1C100I010C1
10I0C01I1111C0I11
11111111111111111