1111111111111
100B00000BC01
10C00IBBBBBB1
1P0011I000E01
1111111111111