1111111111111
1P01000001C01
10C0011111111
1000111000E01
1111111111111