1111111111111
1E0000C000C01
10C0000000001
1P00000100C01
1111111111111