1111111111111
1001000001C01
10C0011111111
1P00111000E01
1111111111111