1111111111111
1001000000001
1000011111001
1000111000E01
1111111111111