1111110111111
1001000000C01
0000011111001
1P001CB000E01
1111111111111